############
#---########
#-#-#---X###
#-------####
###-#-X---##
#---#------#
#-#--#######
#------#####
############
